XXXXXXXXXXXXXXXXXXXXXXXXXXXXXXXXXXXXXXX
X11c4231112221122XX1111X1X1121X2111121X
X1112232222113222XX22232X1X222X12X1221X
XXXXXXX22211X3333XX1113XXXXXX1X21XXX11X
X22111X11222X2244XX2223X111111X112X1XXX
X22121X11222X2311111113X1XXXXXXXX1XX11X
X22121X22211X2312223113X11121X1221X1XXX
X22121X22211X2311113113XXXX11X1XXXXX11X
X12124342222X1111d33333X667711111bX1XXX
X21112XXXXXXXXXXXXXXXXXX55XXXXXXXXX221X
X2222222222222223XX111111111121X111211X
X2233333333332232XX211XXXX11221X122XXXX
X2222222222222323XX111222X122112221111X
XXXXXXXXXXXX3323321211112XXXXXXXXXXXXXX
X1111111111XX1232212111112222222112211X
X111XXXXXX21XX111133322221111111121321X
X11111111X321XXXXXXXXXXXXXXXXXXX123211X
X22113a22X3222222222211111111122131121X
X33333333X3111111111111111111111111111X
XXXXXXXXXXXXXXXXXXXXXXXXXXXXXXXXXXXXXXX